w:11
h:8
  0,  0,  0,  0,  0,  0,  0,  0,  0,  0,  0
  0,100,100,100,  0,100,100,100,100,100,  0
  0,  0,  0,100,  0,100,  0,  0,  0,  0,  0
  0,  0,  0,100,  0,100,  0,  0,  0,  0,  0
  0,  0,  0,100,  0,100,  0,  0,  0,  0,  0
  0,  0,  0,100,  0,100,  0,  0,  0,  0,  0
  0,100,100,100,  0,100,100,100,100,100,  0
  0,  0,  0,  0,  0,  0,  0,  0,  0,  0,  0